без/бес:отсутствие [безветрие, бессердечие, безлюдье, безрукий, безголосый, зеззубый]; противоположность [бездействие, беспорядок, безболезненный, безграмотный]
в: внутрь [вход, войти]; вверх [вкатить, влезть]; углубление действия [вдуматься]
во: внутрь [вобрать, войти, волью, вовью, вошью, вопьюсь, воткать, воткнуть, вобрать, вогнуть, водворить, вомну, вовлечь];
воз: вверх [возноситься, возрастать]; начать [возгореться]; интенсивно [возжелать]; результат [возмужать, возвещать, возблагодарить]; возобновление [возобновить, возродить]
вос: вверх [воспарить, восстать, восходить]; начать [восплакаться, воссесть]; заново [воссоединить, воссоединить, восстановить]; совершенность [восхвалить, восхвалять]
вз: начать [вздуриться, взвыть]; возвышенность [взгорье]; прилегание [взморье]; вверх [взбежать]; внезапность [взъяриться]
вс: прилегать [всполье]; внезапность [вскрикнуть, вскипеть, взбрыкнуть, вздуматься, взбрести, вскочить]; результат [вскипеть, взрастить]
вне: запредельно [внеслужебный, внеклассовый, внебюджетный]
внутри: в глубине [внутривенный, внутримышечный, внутриутробный]
вы: движение изнутри наружу [выгнать, выгрузить, выехать]; изъятие [выбить, выгрызть, выломить], завершенность [выиграть, высидеть, выследить, выполнить]; совершенность [выговориться, выплакаться, выспаться]
до: предшествие [довоенный, допушкинский; доврачебный, добрачный, довоенный, доисторический, досрочный, дохристианский, доистория, докембрий]; достижение предела [доехать, дожить, добела, догола, досыта, допьяна, допоздна, дотемна, донельзя]; завершенность [дочитать, докрасить]; добавление [доплатить, добирать, добрать, докупать, докупить, добавлять, добавить]; полнота [дословный]; преждевременный [досрочный, донаучный]; доведение до результата [достучаться, докуриться, добегаться, доиграться, допрыгаться, дошутиться]
за: движение за предмет [заложить, заслать]; обильность [задарить, закидать]; начало [запеть, заиграть, заснуть]; кратковременность [заехать, забежать, зайти]; предотвращение [запить, занюхать]; повторяемость [забег, заплыв, заезд]; покрыться [замшеть]; приобретение [задеревенеть]; близость [закраина]; наполнение [захламить, задымить]; немного [заморозки]; заполненность [закамышованный]; полное погружение [заслушаться, заиграться, засмотреться]; 
из: сильно [изморозь]; интенсивность [иззябнуть]; предел [измошенничаться, израсходовать]; распространение [изъездить]
изо: предел [изолгаться]; равенство [изолиния, изомерия, изотропия]; изобразительный [изостудия] 
ис: интенсивность [иссохнуть]; предел [исстрадаться, исчертить]; удаление [исключить]
контр: ответный [контрудар, контрмера, контрразведка]
меж: между [межведомственный, межреберный, междугородный, межкостный, межгорье]; в перерыве [межсезонье]
между: между [междуречье, междуцарствие]
на: действие на поверхность [наклеить, налепить, натянуть]; направление действия [налететь, навести]; слабо [наиграть, напеть, насвистывать, накрапывать]; длительно [накручивать, названивать]; находиться на поверхности [наколенник, наконечник, намордник, наушник]; избыточность [набегаться, нагореваться, навоеваться]
над: сверху [надгробие, надбровье, надкрылье, надводный, надкостный]; выше [надклассовый, надвидовой]; увеличение [надстроить, надвязать]; неполнота [надстроить, надвязать]
наи: очень [наилучший, наивысший, наиважнейший, наипервейший]
не: отсутствие [непорядок, неудача, неправда, несчастье, непогода, неверие, незлобный, нелюдимый]; неспособность [непоседа, недотрога, нехватка, неувязка, неполадка, несчастный, неприкосновенный, несомненный, несравненный, нещадный, неумеха]; противоположность [небылица];
небез: частично [небезопасный, небезосновательный, небезызвестный]
недо: частичность [недовыполнить, недоесть, недооценить, недоумок]
низ/нис/нисо: вниз [низвести, низойти, ниспасть]
о/об/обо/оби: вокруг [облететь, обойти], удаление [обломать], распространение [объехать]; мимо [обогнуть]; окружение [обложить, обсахарить]; опреждение [обыграть], чрезмерность [опоить], ошибочность [обсчитать], результативность [осмелеть]; стать [одуреть, обалдеть]; место [обочина, ошейник, оголовок, огузок]; однократность [ополоснуть]; ошибка [оступиться, оговориться, ослышаться]; прийти в себя [одуматься, очнуться]; подобие [очеловечить, обелить]; превращение [осиротить]
обез/обес: лишение [обеспамятеть, обезрыбеть, обезжирить, обеззаразить, обесточить]
от/ото: подобие [отзвук]; отделить [отбежать, отломать, отпилить, отпить, отрезать, отсоединить]; прекращение [отзвучать, отпеть, отцвести]; заставить отказаться [отговорить, отучить]; ответ [отдарить, отплатить, отблагодарить, отомстить, откликнуться]; интенсивность [отплясывать]; возврат [отмокнуть]; происходить [отглагольный, отымённый]; частичность [отголосок]; избавиться [отшутиться, отмолчаться]; удаление [отъехать]; завершение [отработать]
па: подобие [пасынок, патрубок, паводок]
пере: повторение [пересуд, пересев, перезаезд, перевыборы]; очень [перевозбужденный]; через [перенести, перекочевать]; заново [перекроить, пересеять, переучить]; разделить [перегрызть, перерезать]; многократность [перепробовать, перебудить, переженить]; чрезмерность [перехвалить, перекормить, переплатить, перегреть, перестарок]; законченность [перепугать, перемерзнуть, переполошить, перетрусить]; превзойти [переиграть, переспорить, перехитрить]; между [перелесье, перемирие, переносица, перешеек, переулок]; повторность [пересортица]
по: длительность [поиск, потуги]; способ [покрой, поступь]; предмет [поклажа]; более [получше, похуже, посильнее, послабее, поменьше, пониже, поближе]; немного [поотстать, поизноситься, поостеречься, пообсохнуть]; завершенность [померзнуть, побить, поглотать, погноить]; недолго [побеседовать, покурить, полюбезничать, полюбоваться, понаблюдать]; начать [побежать, повеять, погнаться, понести, поплестись, поплыть]; закончить [поблагодарить, построить, погасить, погибнуть]; около [побережье, поморье, полесье, пограничный, подорожный, поволжский, поднепровский]; стать [посерьезнеть, покрасиветь, посчастливиться]; периодически [помешивать, повизгивать, побаливать, покашливать, поругивать]; сделать [повысить, понизить, пояснить]; после [посмертный, пореформенный, пореволюционный, пополуденный]
под/подо: подраздел[подвид, подкласс, подгруппа]; ниже рангом чем [подполковник, подпоручик, подпрапорщик]; ниже [подзаголовок, подпол, подпочва, подсознание, подтекст, подножка, подсвечник, подснежник, подкаблучник, подзатыльник, подводный, подкожный, подоблачный]; вверх [подлететь, подбросить, подпрыгнуть]; приблизиться [подойти, подкатить, подскакать, подтащить]; частично [подбодрить, подзабыть, подзакусить, подкоротить, подкислить, подновить]; дополнительно [подварить, подгрузить, подкопить, подлить, подмешать, подсыпать]; тайно [подсказать, подбросить, подговорить, подсмотреть, подслушать]; удалить остатки [подлизать, подскрести, подъесть]; сопровождение [подыграть, подпеть, подхихикнуть]; завершить[подмести, подсчитать]; ниже [подглазье, подземелье, поднебесье, подножие]
поза: предшествие [позапрошлый, позавчерашний]
после: после [послевоенный, послеобеденный, послеоперационный]
пра: родственник [прадед, прабабушка, правнук, правнучка]; родоначальник [прародина, праязык, праславяне]
пре: слишком [предобрый, прескучный, пренеприятный, превозносить, преувеличить, преуменьшить]; преградить [преградить, пресечь, прекратить]; прекратить [претворить, превратить, преобразовать]; 
пред: предшествие [предгорье, предместье, преддверие, предвестие, предчувствие, предбанник, предрассветный, предгорный, предвыборный, предыстория, предромантизм,  предусилитель]
при: закончить [прийти, приобрести, привезти, прилепить, прилететь, прилипнуть, присохнуть]; частично [приглушить, привстать, призадуматься, приоткрыть, прихворнуть, прилгнуть, прихвастнуть]; сопутствие [прикупить, приплатить, присочинить]; дополнительный [призвук, признак, привкус]; угождать [прихвостень]; приближаться [приземистый, пришурупить]; вызвать желание [приохотить, пристрастить]; около [прилистник, привратник]; близко [придорожный, пригорок, приступок, приморский, призаводской]; совершить действие [прислушаться, присмотреться, приглядеться, принюхаться, притерпеться, прижиться, приесться, примелькаться, притронуться, пригрезиться, привидеться]
про: принадлежность [профашист]; заместитель [проректор, проконсул]; кусочек [проседь, прозелень]; сквозь [пройти, провезти, прогореть, прогрызть, продавить, продымить, прожечь]; преодолеть [пробежать, проплыть, проползти, прошагать]; тщательно [проварить, продумать, прожарить]; израсходывать [проесть, прожить, пропить]; пропустить [проглядеть, прогулять]; длительно [прождать, проискать, просидеть]; совершить [прослезиться, провиниться]; вглубь [прокусить, проскочить, прострелить]; слишком [прожорливый, прозорливый]; однократность [проснуться, простирнуть]; частично [продолговатый]; между [простенок, пролесок, проселок]; ошибочно [просчитаться, проговориться, проболтаться, проторговаться]; прийти в норму [проспаться, прокашляться, проплакаться]
противо: противоположность [противовес, противодействие, противотечение, противоестественный, противовоздушный, противохимический, противоядие]; против [противозаконный, противопожарный, противошумный]
раз/разо/рас: разделение [разводье, распутье, расщелина]; направление в разные стороны [разлапистый, разбежаться, разбрестись, рассохнуться, разрастись, разослать, разломать, развеять]; распространить [распылить, расщепить]; вызвать чувство [раззадорить, разъярить, разохотить]; лишить [разоружить, расчехлить, раскавычить, раскулачить, расчеловечить, разобщить]; сделать [разъяснить, разредить, расслабить]; отсутствие [распутница]; обладающий признаком [расторопный]; интенсивно [разбушеваться, размечтаться, разворчаться, растолстеть, разбранить, разволновать, раскормить]; слишком [раскрасавец, развеселый, разнесчастный, разлюбезный, раскудрявый, распрекрасный, расчудесный]; полностью [рассмотреть, растолковать, разузнать, расспросить, разгромить, рассердить]
c: проявить признак [смилостивиться, сжалиться]; создать [скучить]; наделить признаком [сжидить, скособочить, снизить]; соединить [сдвоить, строить]; однократно [сполоснуть, соснуть, сболтнуть]; действие вместе [созвониться, списаться, сговориться]; сойтись [сбегаться, сбежаться, съезжаться, съехаться, стекаться, стечься]; объединение с [соавтор, совладелец, сограждане, сопереживание]; довести до результата [сделать, сгрести, сгребать, склеить, склеивать, согнать, сгонять, снести, сносить]; завершенность [сгнить, сгореть]; сопутствие [соболезновать, сопровождать, сочувствовать, соучаствовать]; однократность [сжульничать, сглупить]
сверх: особенность [сверхчеловек, сверхприбыль, сверхпроводимость]; запредельность [сверхразумный сверхъестественный]; слишком [сверхдальний, сверхсовременный, сверхпрочный]
со: совместно [сослуживец, собеседник, собутыльник, соотечественник, сопредельный, соприродный, соразмерный, соименный, сожитель]
среди: посередине [средиземный, средисезонный, средидневный]
су: совместность [сукровица, суглинок]; похожесть [сумрак]
супер: слишком [суперприбыль, супербоевик, суперигрок]
у: результат [удой, улов, укос]; полностью [улететь, угнать, увить, устлать, укачать, ухлопать, убаюкать, устыдить; усидеть, устоять, утерпеть]; довести до конца [уводить, угонять]; уменьшить [уварить, ужать, урезать, ушить]; близко [угорье]; сохранить [уцелеть]; довести до отрицательного результата [усесться, улечься, убегаться, уработаться, упрыгаться, ухихикаться]; сделать [улетучиться, ухитриться, удосужиться, упорядочить, упокоить, укусить, уронить];  уменьшение размера [усушка, усадка, утруска]; начало [уснуть] 
через/черес: поперек [чересплечный, чересседельный]; чередование [чересполосный, черезбороздный];
чрез: слишком [чрезмерный, чрезвычайно]
а/aн: без [асимметрия, аморальный, апатия, атом, анархия, ангидрид]
аб/абc/ад: возле [абсурд, абориген, абстрактный адаптация, адекватный, аннексия]
амфи: около [амфитеатр, амфора, амфибия]
анти: против [антипатия, Антарктика, антоним, антипод]
апо: прочь [апогей, апостроф, апофиз]
архи: главный [архипелаг, архитрав, архиерей, архиплут]
би/бин: пара [биплан, биатлон, бином, бинокль, бицепс]
вице: вместо [вице-губернатор]
гипо/гипе/гипер: сверх [гипоцентр, гипотоник, гипофиз гипертрофия, гипербола, гиперборей, гипертония]
гипп: лошадь [гиппопотам, гиппарх, ипподром]
глоб: шар [глобула, гемоглобин, глобус, глобальный]
грамм/граммат: буква, запись [грамматика, стенограмма, программа, телеграмма, граммофон]
граф: начертание, описание [графа, график, графит, графоман, телеграф, география]
гуман: человечный [гуманист, гуманистический]
де: отделение, отмена, вниз [демобилизация, демонтаж]
диа: между [диагональ]; через [диаметр]; 
мета: после [метагалактика, метафора, метаморфоза]
дис: отсутствие [дисперсия, диссонанс, дисгармония, дискриминация]
ин/им: внутри [интерьер, инъекция, инкогнито, импорт, иммунитет]
интер: между [интервал, интермедия, интернациональный, интернат]
ком/кон/кор/ко: вместе [компресс, коллегия, кондуктор, корреспондент, коалиция]
контр/контра: против [контрреволюция, контрабанда, контратака, контраст]
мета:  после [метафора]
мульти: много [мультимиллионер, мультфильм]
пан/панто: весь [панорама, паноптикум, пантеон, пандемия, пантомима]
пара: против [паразит, парадокс]
пери: вокруг [период, периметр, перископ]
пост: после [постимпрессионизм]
пре: перед [префикс, прелюдия, президент, президиум, прецедент]
про: вперед [прогресс, проформа, протекция, протез, процент]
ре: вновь [реконструкция, репатриация, реакция, ревизия, регенератор]
сим/син: вместе [симметрия, симбиоз, синоним]
суб: снизу [субтропики, субмарина, субстрат, субординация, субтитры]
теле: далеко [телефон, телевизор, телескоп, телеграф, телепатия]
транс: через [трансураны, трансатлантический, транспорт, трансмиссия, транзит]
ультра: слишком [ультрамикроскоп, ультрамарин]
эко: извне [экслибрис, эксцесс, экспроприация, экспонат]
эпи: после [эпиграф, эпигон, эпилог, эпитет]; возле [эпицентр]