авто: сам [автобиография, автомобиль, автограф, автомат, автономия]
авиа: птица [авиация, авиасалон, авиапилот]
агр: поле [агроном, агротехника]
акв: вода [акватория, акведук, аквариум, акваланг, акварель]
акт: действие [акт, акция, актив, антракт, контракт]
андр: мужчина [андроид, скафандр, полиандрия]
антроп: человек [антропология, питекантроп, синантроп, филантроп, мизантроп]
астро: звезда [астра, астрология, астронавт, астрономия]
аэро: воздух [аэроплан, аэродром]
бар/бари: тяжесть [барий, баритон, барометр, барокамера, изобары]
белл: красивый [беллетристика, белладонна, бельканто, бельэтаж, бельведер]
би/био: жизнь [биология, биотоп, автобиография, анабиоз, симбиоз]
библио: книга [библиотека, Библия, библиография]
видео: вижу [видеотехника, видеоклип]
вит: жизнь [витализм, витальный, витамин, авитаминоз]
гала/галакт: молоко [галактика, галалит, галактоза, Галактион]
гелио: солнце [гелиотроп, гелиобактерия]
гео: земля [география, геология, апогей, перигей, Георгий]
ген: происхождение [гены, генеалогия, генетика, фосген]
гидр: вода [гидра, гидрат, гидрант, гидроплан, гидроним]
дем: народ [демократия]
дендро: дерево [дендрарий, дендрология]
дерм: кожа [эпидермис, дерматолог]
дик/дикт: говорить [дикция, диктант, диктор, диктофон, вердикт]
док: учение [доктрина, доктринер, доктор, доцент, докторантура]
дром: бег [дромадер, палиндром]; площадка [синдром, аэродром, космодром]
ду: пара [дубль, дублет, дублер, дуэт, дуэль]
завр: ящер [динозавр]
зоо: животное [зоология, зоопарк]
из: равный, подобный [изобары, изомеры, изоморфизм, изотопы, изохронизм]
ихтио: рыба [ихтиолог, ихтиозавр]
кардио: сердце [кардиология, кардиограмма]
кине: движение [кинетика, кинескоп, кинематограф, кинема, кинематика]
кап/капит: глава [капитан, капрал, капитал, капут, капюшон]
космо: вселенная [космос, космонавт, косметика]
крат: власть [демократия, аристократ, бюрократия]
лабор: труд [лаборатория, лаборант]
лиз: растворение, разложение [лизол, анализ, гидролиз, электролиз, катализатор]
лит: камень [литий, литография, монолит, палеолит, текстолит]
лог: слово [монолог, логопед, филолог]; учение [геология]
макро: большой [макромир, макроэкономика]
макси: наибольший [максимальный, максимализм]
ман: любить [меломан, графоман, мания, библиомания]; рука [мануфактура, мануфактура]
ману: рука [манипуляция, маникюр, маневр]
меди: середина [медиана, медиатор, медиум, интермедия]
мега: большой [мегаполис]
мезо: средний [мезодерма, мезоклимат]
мел: музыка [мелодия, мелодика, мелодекламация, мелодрама, меломан]
метр: мера [метрология, метроном, тригонометрия, геометрия, симметрия]
микро: малый [микроб, микрон, микрофон, микроскоп, микроклимат]
мобил: подвижный [автомобиль, перпетуум‑мобиле, мобилизация, мебель]
моно: единый [монолит, монолог, моноплан, монархия, монополия]
навт: корабль [навигация, космонавтика, навигатор, аргонавты, аэронавт]
нез: остров [Индонезия, Полинезия, Микронезия, Меланезия]
нейтр: среднее [нейтральный, нейтралитет, нейтрализация, нейтрон, нейтрино]
не/нео: новый [неон, неологизм, неофит, неодим, неофашизм]
ном: закон [номография, агроном, астроном, автономия, экономика]
окул: глаз [окулист, окуляр, монокль, бинокль, окулировка]
оле: масло [линолеум, валидол, оливин, олеография]
оном/оним: имя [псевдоним, синоним, метонимия, топонимика]
орнито: птица [орнитология]
орт/орф: правильный [орфография, орфоэпия, ортопедия, ортодокс]
палео: древний [палеозой, палеонтолог]
пат/паф: чувство [пафос, патетика, патология, гомеопат, телепатия]
пир: огонь [пирит, пирамидон, пиротехника, пироксилин, аспирин]
поли: много [полигон, полиглот, полиграфия, поликлиника]
пом: плод [помология, помада, помидор, померанец]
порт: носить [портфель, портативный, экспорт, транспорт, рапорт]
ради: луч [радий, радиус, радиан, радиатор, радио]
сан: здоровый [санитария, санитар, санировать, санаторий, ассенизатор]
скоп: смотреть [калейдоскоп, телескоп, перископ, микроскоп, рентгеноскопия]
скрип/скрипт: писать [транскрипция, манускрипт, рескрипт, конскрипция, постскриптум]
сон: звук [соната, унисон, клаксон, резонанс, диссонанс]
спек/спект: обзор [спектр, проспект, спектакль, конспект, инспекция]
текс/текст: ткать [текстура, текстиль]; соединять [текст, контекст]
термо: тепло [термометр, термос, термостат, термоизоляция, изотермы]
терр: земля [терраса, территория, террикон, терракота, партер]
тип: отпечаток [генотип, типичный]
том: часть [том, атом, атомистика, анатом, остеотомия]
топ/топо: место [тополог, топоним, топография, утопия, изотоп]
фаг: пожирающий [фагоциты, бактериофаг, антропофаг, саркофаг]
фант: воображение [фантазия, фантастика, фантом, фантомас, фантасмагория]
физ/физи: природа [физика, физиология, физиотерапия, физиономия]
фил/фило: любить [филолог, филантроп, филармония, филателия, библиофил]
фон/фоно: звук [фонетика, фонология, граммофон, симфония, магнитофон]
фор: носитель [фосфор, светофор, семафор, метафора, Христофор]
форт: сильный [форт, форте, фортификация, фортепьяно, форсировать]
фос/фото: свет [фосфор, фосген, фотография, фотон, фотогеничность]
хрон/хроно: время [хроника, хронология, хронометр, синхронный]
циркул: круг [цирк, циркуль, циркулировать]
экв: равный [эквивалент, экватор, эквилибрист, адекватный]
эпо: слово [эпопея, эпос, орфоэпия]
юр: право [юрист, юрисконсульт, юриспруденция, жюри]
Юб: юбка
Юг: юг
Юдол: юдоль
Юз: юзать
Юл: юла
Юн: юный
Юр: юркий
Ед/ест/яст: еда
Ед/езд/езж/ех: еду, ездить, ехать, проезжий
Еж: еже
Ёж: ёж
Ёл/ел: ель, ёлка
Ёр(н): ерничвть
Ёрш: ёрш, ершистый
Ест: есть
Ещ*: ещё
Я: язъ
Ябл: яблоко, яблочный; яблоня, яблоневый
Яв: явь, явный, явиться, проявить, явка
Явор: явор
Ягел: ягель
Ягн: ягня
Ягод: ягода
Яд: ядъ
Яд(р): ядро
Яз: язь
Язв: язва
Яз(ык): язык, языковой
Яй(ц)/яи(ч): яйцо, яичный
Ял: ялая
Ям: яма
Яр: яр
Яс: ясли
Яр: ярый
Ярем/ярм: ярмо, яремный
Яс/ос: ясень
Ясн: ясный
Яст(р): ястреб, ястребиный
Ят: взять
Ят(р): ятровь
Яч: ячать
Яч: ячка, ячневый; ячмень, ячменный
Ящ(ер): ящер, ящерица
А: ась
А: абы
Аб: абие, абье
Абл: абло
Агн: агнец
Агод: агода
Аз: азъ
Ак: аки
Алк: алкать
Ка(р/зн): кара, казнь, карать
К/ко: кто, куда, где, как, когда
Кад: кадка
Кад/чад: кадить; чадить
Кай: каяться, окаянный
Кал: калить, калёный
Кал: кал
Кам(ен): камень, каменный
Кат/кач: катать, катить, катушка; качать, качели, накачивать
Каш: каша
Квас: квас, квасить, квашеный
Кив: кивать, кивок
Кид: кидать
Кип: кипеть, кипяток
Кис: киснуть, кислый, кислота
Кист: кисть
Киш: кишеть, кишмя
Клад/клаж/клас: клади, класть, клад; поклажа
Клев/клюв: клевать, клёв; клюв
Клен/клён: клён, кленовый
Клеп/клёп: клепать, заклёпка
Клей: клей, клеить, клейкий
Клет: клетка, клеть
Клеш: клешня
Клещ: клещ, клещи
Клин: клин, клинить
Клин/кля(т,с): проклинать; клясть, клятый
Клик/клич: кликать, клич
Клок/клоч: клок, клочья, всклокоченный; склоки, склочный
Клоп: клоп
Клуш: клушка
Клык: клык
Клюк(в): клюква
Ключ: ключ, ключевой
Кляч: кляча
Книг/книж: книга, книжный
Кноп: кнопка, кнопить
Кнут: кнут
Ков/ку: ковать, куй; кузня, кузнец
Ког(от): коготь, когти
Кож: кожа, кожаный
Коз: коза, козел, козий
Кол: кол, колоть
Колд: колдун, колдовать
Ком: ком, комкать
Кон/чин: кон, конец; начинать, начало
Коп/кап: копать, раскапывать
Кор: кора
Кораб: корабль
Короб: коробка, коробить
Коров: корова
Корон: корона
Корот: короткий
Кос/чес: косить, коса, косой; чесать
Кост: кость, костный, костить
Кот/кош: кот, кошка
Кох: кохать
Коч: кочка
Кош: кошель, кошелёк
Краб: краб
Крад: кради, красть, кража
Край/крой: край, кроить
Кран: кран
Крас: красить, красный, окрашен
Крен/кряж/круг: крен, кренить
Креп: крепить, крепкий
Крест/крещ: крест, крещение
Крив: кривить, кривой, кривда
Крик: крик, кричать
Крой/кры: крыть, крой
Крол: кролик
Кром: кромка, кроме, кромешный
Крот: крот
Крох/крош/круш: кроха, крошка, крушить
Круп: крупный, крупа
Крыж: крыжить
Крыж: крыжовник
Крын: крынка
Крюк: крюк, крючок
Куб: куб
Куд/чуд: кудесник; чудо
Куд(р): кудри, кудрявый
Кук(л): кукла
Кум: кум
Кун: куница, куний
Кур: курица, куриный
Кур: курить
Кус/куш: кусать, кусок; кушать
Куст/кущ: куст, куща; частый, чаща
Куц: куцый
Куч: куча
Ш: ш
Шаг/шаж: шагать, шаг, шажок
Шал: шалить, шалость, шальной
Шевел: шевелить
Шед/шес/шё/ш: шедший, шествовать, шёл, шли
Шей/ши/шь/шов/шв: шей, шить, шью, зашивать; шов, швы; шило
Щелк/шёлк: щёлкать, щелчок
Шелом/шлем: шелка, шёлковый
Шелох: шелохнуть
Шерст/шёрст: шерсть, шерстяной, шёрстка
Шерох/шорох/шерш/шурш: шершавый; шорох; шершень
Шип: шип, шиповник, шипастый
Шип: шипеть, шипение
Шиш: шиш, шишка, шишак
Шлем: Шлем
Шлеп/шлёп: Шлёпать, шлепок
Шлях: шлях
Шмал: шмалить
Шмат: шмат, шмот(ок)
Шмел: шмель
Шмыг: шмыгать
Шрам: шрам
Шуб: шуба
Шуй: шуя
Шум: шум, шумный, шуметь
Шуст(р): шустрый, шустрить
Шут/шуч: шут, шутка, шутить, шучу
Щав: щавель
Щад: щадить
Щеб: щебет, щебетать
Щёг: щёголь
Щед: щедрый
Щек: щека
Щек(от): щёкот, щёкотно, щекотать
Щел: щель, щелевой
Щелк: щёлкать, щелчок
Щем: щемить, ущемить, защемлять
Щен: щенок, ощениться
Щеп: щепка, расщеплять
Щер: щерить
Щёт: щётка
Щип: щипать
Щир: щирый
Щит: щит
Щук: щука
Щуп: щуп, щупать
Щур: щурить
Сад/сод/сед/сид/сяд: садить, сажать; сел; сидеть, рассиживаться; сядь
Сазан: сазан
Сал: сало, сальный
Сам: сам
Сан: сани, санный
Сач: сачок
Сва(т): сваха; сват, сватать
Свекл: свекла/свёкла, свекольный, свекольник
Свекр: свёкр, свекровь
Свет: свет, светлый
Свин: свинья, свиной
Свир(ел): свирель
Свист: свист, свистеть, свисток
Свит: свита
Своб: свобода, освободить
Свор: свора
Се: сей, сия, сиё
Себ/соб/св: себя, собой
Север: север, северный, северянин
Сей/сев: сеять; сев
Сек/сеч: секу, сечь; секира; засека
Сел: селить, село
Сен: сено
Сен: сень, сени
Сер: серый, сереть
Сереб(р): серебро, серебряный
Серед/сред/серд: середина, серёдка; сердце, сердечный, сердить
Сер(ьг/ёг): серьга, серёжки
Сес(тр): сестра
Сет: сеть
Сив: сивый
Сиг: сиг
Сиг: сигать
Сиз: сизый
Сил: сила, силач, сильный, усиливать
Син: синий, синева, синеть
Сип: сиплый, сипеть, осип
Сир: сирый, сирота, осиротеть
Скал: скала, скальный
Сквер: скверный, осквернять
Сквоз: сквозь, сквозить, сквозной, насквозь
Сквор: скворец, скворечник
Скит: скит, скитаться, скиталец
Скольз: скользкий, скользить
Скором: скоромный
Скот: скот, скотина, скотный; скотский
Скреб/скрёб: скребу, скребок, скрести, скрёбся
Скреж: скрежет, скрежетать
Скуд: скудный, оскудеть
Скук: скука, скучный, скучать
Скул: скула
Скуп: скупой, скупость
Слаб: слабый, слабость, слабина, слабак, ослаблять
След/слеж: след, следовать, следить; слежка, слежение
Слеп: слепой, слепнуть, слепец
Слив: слива, сливовый
Слой/слай: слой, наслаивать
Слов/слав/слы(в): слово; слава, славить, славный
Слон: слоняться, прислониться
Слуг/служ: слуга, служба
Слух/слуш/слых/слыш: слух, слушать; слыхать, слышать
Слюд: слюда
Смак/смач: смак, смаковать, смачный
Сме: сметь, смелый
Смех/смеш: смех, смешить, смешной
Смерд/смород/смрад: смородина; смердеть
Снаст: снасть
Снох: сноха
Со/с: с/со
Сов/су: совать, сунуть, суй
Сок/соч/сос: сок, сочиться, сочный
Сол: соль, соленый, солить
Солод/слад: солод
Сом: сом
Сон/сн/сп/сып/соп: сон; сниться; спать; засыпать; усопнуть
Соп: сопеть, сопатка; сопли
Сор: сор, сорить, сорный
Сорок: сорока, сорочий
Сос: сосать
Сосн: сосна
Сот/ст: сотня, сто
Сох/сых/сух/суш: сохнуть; засыхать; сухой, сушить
Спе: спеть, спелый
Спес: спесь, спесивый
Спин: спина
Спор: спор, спорить, спорный
Сра: ср@ть, ср@ка
Срам: срам, срамной, осрамить
Стай: стая, стайный
Стар: старый, стареть, старость, старец, старческий; старший, старшина, старшинство
Стег/стёг/стёж: стегать, стёжка, стёганный; пристегнуть
Стел/стил/стол: стелить, постель; застилать, настил; стол, столовый, стольный, столица, столичный
Стен/стон: стенать; стонать, стон
Стерв: стерва, стервозный, остервенеть
Стерег/стереч/сторож/страж: стерегу, стеречь, остерегаться; сторожить, сторож, сторожка, осторожно
Стой/ста: стоять; стать, ставить, оставить; стан, станица, станок; остановить, остановка
Сторон/стран: сторона, посторонний, сторониться
Страд/стражд: страдание, страдать
Страх/страш: страх, страшный, устрашить
Стрев/стря: застревать, застрять
Стрех: стреха
Стриг/стрич: стриг, стричь
Строг: строгий, строгость
Строг/струг: строгать, стружка
Строк: строка, строчка, строчить
Стряп: стряпать, стряпня
Студ/стуж: студённый, студень, стужа, остужать
Стук/стуч: стук, стучать
Сын: сын, сыновний
Сып: сыпь, сыпать, сыпной
Сыр: сырой, сыреть
Сыт/сыщ: сыт, сытный, сыть; насыщать, насыщенный
Чад: чадо, домочадцы
Чад: чад, чадить
Чай(к): чайка
Чал: чалый
Чан: чан
Чар: чары, очаровать
Чар(к): чарка
Час: час, часовой
Част/чащ: часто, чаща
Част: часть, частный
Чах: чахнуть, чахлый
Чел: чело, человек
Челюс: челюсть
Чер(в): червь; червоный
Черед/черёд: чередовать, очередь, черёд
Через: через
Черен: черенок
Череп: череп, черепаха
Чёрм: чёрмный
Черн/чёрн: чёрный, чернить
Черп: черпать
Черст/чёрст: чёрствый, черстветь
Черт/чёрт: черти, чёрт
Черт/чёрт: черта, чертить
Чес(н): чеснок
Чест: честь, честный
Чиж: чиж
Чин: чинить, чин, чиновник, чинный
Чир: чирей
Чист/чищ: чистый, чище; честь
Чит/чт/чёт: почитать, чтить, почёт; честь, честный
Чит/чт: читать, чтение
Чит/чёт/чис(л): считать; счёт, число
Чит/чт/чёт: почитать, чтить, почёт
Член: член
Чу: чутьё, чуткий; чуять; чувство, чувствовать
Чуб: чуб, чубатый
Чуд: чудо, чудеса, чудесный, чудить
Чуж: чужой, чужбина
Чум: чума, очумелый
Чур: чур, чураться
Чуш: чушь
Уд: уд
Уз, узд: узкий, сужать
Уж: уж
Уж: уже
Ук/уч/вык: учить, наука, навык, привычка
Ул: улей
Ум: ум, умный, уметь
Ус: усы
Уст: уста, устный; устрица
Ут: утка
Ут(л): утлый
Ух: ухо, ушной
Ух/юш: уха
Гад: гад, гадкий, гадить
Гал: галка
Гас: гасить, гашение
Гат: гать
Гвозд: гвоздь
Глагол: глаголить
Глад/глаж: гладкий, гладить, глаженный
Глаз: глаз
Глин: глина
Глист: глист
Глот: глотать, глотка, глоток
Глум: глумиться
Глуп: глупый, глупеть
Глух/глох: глухой, глушить; глохнуть
Глыб: глыба
Гляд: глядеть
Гнев: гнев, гневить
Гнед: гнедой
Гнезд: гнездо
Гнет: гнёт, угнетать, гнетущий
Гнид: гнида
Гной/гни: гной, гнилой, гнить
Гнус/гнуш: гнус, гнусный, гнушаться
Говор: говорить, разговор
Год: год, годный, угодить
Гол: голый, оголять
Голов/глав: голова, головной
Голод: голод, голодный, голодать
Голос: голос, голосовать, голосить
Голуб: голубь
Гн/гон: гнать, гонять, гон
Гор: гора, горный
Гор: горько
Гор/жер: горло; жерло
Гор: гореть
Горб: горб, горбатый
Горд: гордый, гордиться
Город: город, городской, горожанин, городить, огород
Горст: горсть
Горш: горшок
Гост/гощ: гость, гостить, угощать
Гот: готовый
Граб: грабить, грабёж
Граб: грабли
Граб: граб
Гран: грань, граница, огранить
Грез: грезить, грёзы
Грей/грев/гре: грей, греть, нагревать
Греб/грест: гребу, грести
Грех: грех, грешить
Гриб: гриб, грибной
Грив: грива
Гроб: гроб, гробить
Гроз: гроза, грозный, грозить
Гром/грем: гром, громить, греметь
Грох: грохать, грохот
Грош: грош
Груб: грубый, грубить
Груд: грудь, груда
Груз: груз, грузить, грузный
Груст/грущ: грусть, грустно, грустить, грущу
Груш: груша
Грыз/грыж: грызть; грыжа
Гряд: гряда
Гряд: грядет
Гряз: грязь, грязный
Губ/гиб: губить; гибнуть, гиблый, гибель
Гуд/гул: гудеть, гудок, гул, гулкий
Гуз: (задняя часть тела птицы). Также  <i>гужевой
Гул: гулять
Гум: гумно
Гус: гусь, гусыня, гусёнок
Густ/гущ: густой, гуща
Лав: лава
Лав: лавка
Лад: лад, ладить, ладный
Лаз/лез: лаз, лазить, лезет
Лай: лай, лаять, лайка
Лап: лапа, лапать
Ласт: ласты
Лев/льв: лев, львиный
Лег/лёг: легко, лёгкий
Лед/лёд: лёд, ледяной
Лей/ли(в): лей, лить, ливень, литой
Лён/льн: .
Лен: лень, лентяй, лениться, ленивый
Лес/леш: лес, леший
Лет: лето, летний, лета
Лет/лёт/леч: летать, лечу, лётный
Лиз/лиж: лизать, лижет
Лик/лиц/лич: лик, лицо, личный
Лип: липнуть, липкий, липа
Лист: лист
Лих/лиш: лихой, лишний, лишать
Лоб: лоб, лобный
Лов: лов, ловить, ловкий
Лог/леч/лёг/ляг: логово, ложбина, лежать, ложить, лёг, леч, лягу
Лод/лад: лодка, ладья
Лож/лг: лгать, ложь
Лом: ломать, лом, ломкий
Лон: лоно
Лот: лот, лоток
Луб: лубяной
Луг: луг, лужок
Луд: лудить
Луз: луза
Луж: лужа
Лук: лук
Лук: лук
Лун: Луна
Лун: лунь
Луч: луч
Луч: лучше
Лык: лыко
Люб: любить, любовь, любо
Люд: люди, людный
Ляг: лягушка, лягать, ляжка
Наг/наж: нагий, нагой, обнажать
Наст: наст
Не/ни: не
Неб: небо, небеса, небесный
Нег/неж: нега, нежность
Нед(р): недра
Нем: немой
Нес/нёс/нос/нош: неси, нёс, носи, ноша
Нив: нива
Низ: низ, низкий, нижний; ниспадать
Низ: нанизывать
Ник/ниц/нич: никнуть, ниц, ничком
Нит: нить
Ниш: ниша
Нищ: нищий
Нов: новый
Ног/нож: нога, ножной
Нож: нож
Нор: нора
Нос: нос
Ноч: ночь, ночной, ночевать
Нуг: нуга
Нуд: нудный
Нуж/нужд: нужный; нужда
Нут(р): нутро, нутряной
Нык: ныкать
Ныр: нырять
Нюх: нюхать
Нет: неть
Та: таять, талый
Тай: тайна, тайный, таить
Тест: тесть, тёща
Тл: тлеть
Тл: тля
Тол: толоть
Топор: топор
Топор/топыр: топорщиться; растопыривать
Толм: толмач
Ваб: вабить
Ваг: важный
Вай: ваять, изваяние
Вал: валить
Вар: вар
Ват: вата, ватный
Вдов: вдова, вдовец, вдовый, овдоветь
Вед/вес: веди, вести
Вед/вес: ведать, ведомость, ведьма
Вед(р)/вед(ёр): ведро, ведёрный
Вёд(р): вёдро
Вез: возить
Веж: вежливый
Веж: вежа
Вей: вей, веять, веер, развевать; вЕтер; витать, вьюга
Век: век
Вел: володеть
Вел: великий
Веп: вепрь
Вер: вера
Верб: верба
Верг: ввергнуть
Верес: вереск
Вереск / верезг: верещать, верезжать
Верз: верзти
Верс: верста
Верт/верет/ворот/врат/вре: вертеть, веретено
Верх: верхний
Верш: верша
Вес / вс: вс, вес, весь, все, вьс
Вес: веси
Вес: весёлый
Вес: весна
Вет: ответ
Вет: ветхий
Вех: веха
Вечер: вече
Вид: видеть
Визг: визг, визжать
Вил: вилы; вилять
Вир: вир
Вис: висок
Вис/вес: висеть, вешать, вишня; вес, весить
Вих: вихри
Внук: внук, внучка
Во: вон, вот
Вод: вода
Воз: воз
Воз: возгря
Вой: вой, выть
Вой: война, воевать, воин
Вол: вол
Волг/волог/влаг: Волга
Волк: волк (волочащий, влекущий)
Волок/влак/влек: волок, волочить
Волос/влас: волос, власяница
Вон: вонь, вонять
Воп: вопль, вопить
Вор: вор, воровать
Вор: свора шкворень, шворень
Ворз: паворз
Ворк: ворчать; воруовать
Вороб/враб: воробей
Ворог/враг/вражд: ворог, ворожить
Ворон/вран: ворон, ворона; вран; вороной
Ворох: ворох, ворошить
Воск/вощ: воск, вощить, вощенный
Вош: вошь, вша
Вра: врать врач
Вре: вреть (стремительно плыть)
Вред/веред: вред, вредить
Выдр: выдра
Выжд: выждец
Вын: вынуть
Выс: высь, вышина
Вы: вы, вас, вам
Вый: выя
Вяк: вякать
Вяд/вял/вян: увядать, вялый, вянуть
Вяз: вяз; вязкий
Вят: Вячеслав
Ба: басня
Баб: баба
Бав: прибавить
Баг: багор
Багр: багровый
Бад: бадья
Бал: баловать
Балак: балакать
Бан: баня
Бар: барин
Барс: барс
Барс: барсук
Бат: батог
Бат: батя
Бах: бахать
Баш: башня
Бац: бацать
Бд: бдеть, бдить
Бе: бекать
Бег: бежать
Бед: беда
Бей: бей, бить, бью, бой
Бел: бельё
Белес: блестеть
Бер: бери
Берд: бедро
Берег: берег
Беред: бередить
Берез: береста
Бес: бес
Би: бибикать
Бле: блеять
Блев: блевать
Близ: близь
Блик: блик
Блох: блоха
Блуд: блудить, блуждать; блядь
Блюд: блюдо
Блюд: блюсти
Бляд: блядь
Блях: бляха
Бо: ибо
Боб: бобы
Боб(р): бобр / бобёр
Бог: пагос
Бод: бодать
Боз: боз
Бок: бок
Бол: боль
Бол(ьш): большой
Болог: Бологое
Болон: болонца
Болт: болтать
Болот: болото
Бонд: бондарь
Бор: бор
Бор: бороться, борьба
Борз: борзый
Борм: бормотать
Боров: боров
Бород: борода
Борозд: борозда
Борон: борона
Борт: борт
Борщ: борщ
Бос: босой
Бот: бот
Брав: бравый
Браг/браж: брага
Брак/брач: брак
Бре: бреющий
Брев: бревно
Бред: бреду
Брезг: брезгать
Брей: брой
Брех: брехать
Брен: бренный
Бренч, бряк, бряц: бренчать
Бров: бровь
Брос: бросать
Брус: брусника
Брызг: брызгать
Брык: брыкать
Брюзг: брюзга
Брюк: брюква
Брюх: брюхо
Бу: обуть
Бубен: бубен
Буг: бугай
Буд: будить
Буз: буза
Буй: буйный
Бук: бук
Булк: булка
Бур: буря
Бур: бурый
Бур: бурить
Бус: бусы
Бус: бусый
Бух: бухать
Буч: буча
Буш: бушевать
Бы: быть
Быс(тр): быстрый
Бя: бяка
Жаб: жаба
Жад/жажд: жадный
Жал: жаль, жалко, жалкий, жалеть
Жал: жало, жалить
Жар: жар, жарко, жаркий, жарить
Жа/жим/жм: жать, пожимать, жму
Жа/жн: жать, жну, жнец
Жев/жу: жевать, жуй
Жег/жеч/жиг/жг/жж: жёг, жечь; сжигать; жгу, жжёт
Жезл: жезл
Желез: железа
Желез: железо
Желт/жёлт: жёлтый, желтеть
Желуд/жёлуд: жёлудь
Жереб/жреб: жребий
Жерд: жердь, жёрдочка
Жерт: жертва, жертвовать
Жи: жить, жизнь; живот
Жир/жор/жр: жир, пожирать; прожорливый; жрать
Жук: жук
Жур: журить
Жут: жутко, жуть
Жух: жухлый
Ив: ива
Иг: иго
Игр: игра, игривый
Ид: идти
Ил: ил, илистый
Ин*: иной, иногда
Ин: иней
Иск/ищ: искать, поиск, иск, ищет
Да: дай, давать, дал
Дав: давить
Дав: давно
Дв: два
Двер: дверь, дверной
Двиг: двигать, движение
Двор: двор, дворовый; дворник, дворянство
Дебел: дебелый
Дев: дева, девушка
Девер: деверь
Дед: дед, дедушка, дедовский
Дей/дел: действие, дело, делать
Ден/дн: день, дни, дневной, денно
Дер/дир/дор/др: драть, раздирать, деру, раздор
Дерг: дёргать
Держ: держать
Дерз: дерзкий, дерзость
Десн: десна, дёсны
Десн: десница
Дет/дит: дети, детский
Деш: дешёвый
Див: дивный, удивлять, ливиться
Дик: дикий, диковинный, дикарь, дичь, дичиться
Длан: длань
Длин: длина, длинный
Доб: сдобный, удобный, подобный
Дой: доить, дойка
Док: дока
Дол/дал: дол; даль, далёкий, дальний
Долб: долбить
Долг: долгий, долго
Дом: дом, домашний
Дон/дн: дно, донышко
Доч(ер): дочь, дочери
Драг/дорог: дорогой, дорожить; драгоценный, дражайший
Древ(н, к) / дерев: древко, древесный, дерево
Дров: дрова
Дрог: продрогнуть, дрожать
Дрожж: дрожжи
Дрозд: дрозд
Друг: друг, дружить, дружба
Дрыг: дрыгать
Дрын: дрын
Дряб: дряблый
Дрязг: дрязги
Ду(х/н/в)/дох/дых: дух, душа, дуть, продувать, дуновение; вздохнуть, дошлый; дышать, дыхание
Дуб: дуб, дубина, дубовый
Дуг: дуга
Дур: дурь, дурак, дурить, дурно
Дыб: дыба, на дыбы, вздыбить
Дым: дым, дымить
Дын: дыня
Дыр: дыра
Дят: дятел
О/об/ов: обо, об, о
Ов(од): овод
Озер: озеро
Ок: око, очи, окно, заочный, окоём, очевидно
Олен: олень
Ор: орать
Ор: орать
Ор(ёл): орёл
Ос: оса
Ос: ось
Ос(т): острый
Ос(т): ость
От: отец, отцы
Зад: зад, задний
Зай: заяц, зайка
Зар: заря
Звезд: звезда, звёзды
Звер: зверь, звериный, звереть
Звон/звен/звук/звяк: звон, звонить, звонкий; звенеть; звук, звучать; звякать
Здор: здоровье
Зев: зев, зевать
Зел: зелёный, зелье, зеленеть
Зем: земля, земной
Зерн: зерно
Зид/зд: здание, создатель, созидать
Зий: зиять
Зим: зима, зимний
Злак: злак
Змей/змий: Змея, змей, змий
Зна(к, м, н, т, х): знать, знак, знамя, знание, знатный, знахарь
Зноб: озноб, знобить
Зоб: зоб
Зов/зв: зов, звать
Зол: зола
Зол/зл: зло, злой, зол
Золов: золовка
Золот/злат: золото, золотой
Зор/зир/зерк/зр: зоркий, взор; взирать; созерцать, зеркало; зреть, зрение, зрачок
Зре: зреть, зрелый
Зуб: зуб, зубной, зубастый
Зубр: зубр
Зуд: зуд, зудеть
Зыб: зыбь, зыбкий
Зяб: зябко, озябнуть
Зят: зять
Хай: хаять
Хвал: хвала, хвалить
Хваст: хвастать
Хват: хват, хватать, хваткий
Хвой: хвоя, хвойный
Хвор: хворь, хворать
Хвост: хвост, хвостатый
Хвощ: хвощ
Хит/хищ: похитить, похищать, хищник
Хит(р): хитрый, хитрить
Хлам: хлам, захламлять
Хлеб/хлёб: хлеб, хлебать; похлёбка
Хлев: хлев
Хлест/хлёст/хлещ: хлестать, хлёсткий, хлещет
Хлоп: хлопать, хлопОк
Хлоп: хлопья, хлОпок
Хлын: хлынуть
Хлыст/хлыщ: хлыстать, хлыщ
Хлюп: хлюпать, хлюпик
Хляб: хляби
Хляст: хлястик
Хмар: хмарь
Хмел: хмель
Хмур: хмурый, хмкрить
Хмык: хмыкать
Хмыр: хмырь
Хн: хна
Хол: холить, холка
Холод/хлад/хлажд: холод, холодный, холодеет; прохладный, охлаждать
Холоп/хлоп: холоп, холопствовать; хлопотать
Хор: хор, хоровод
Хороб(р)/храб(р): храбрый
Хором/храм: хоромы; храм
Хорон/хран: хоронить; хранить
Хорош: хорошо
Хоруг: хоругвь
Хот/хоч: хотеть, хочу
Храп: храп, храпеть, нахрапом, нахрапистый
Хрен: хрен
Хрип: хрип, хрипеть, хриплый
Хруп: хрупкий, хрупнуть
Хруст/хрущ/хрящ: хруст, хрустеть, хрущу; хрящ, хрясть
Хрыч: хрыч
Хряк/хрюк: хряк
Хрящ: хрящ, хрящевой
Хул: хула, хулить
Ма: мать; мама
Маг: маг, магический
Маз/маж: мазать, мажет
Май: маяться, маята
Мак: мак, маковый
Мак: макать
Мал: малый
Ман: манить, обман
Мар: марать, маркий
Маст/мащ: масть
Мат(ер): мать, матери
Мах/маш: махать, машет
Мац: мацать
Мед/мёд: мёд, медовый
Мед(л): медлить, медленный
Меж/межд: межа; между
Мел/мол: мели, мельник; молоть, молотьба, помол
Мел: мель, мелкий
Мен: менять
Мер: мера, мерить
Мерз/мёрз: мёрзнуть; мерзкий
Мес/меш: месить
Мест: место, местный
Мест/мст/мщ: месть, мстительный; мщение
Мет/меч: метить, метка, меткий, меченный, отмечать
Мет/мёт/мес: метать; метёт, мести, метла, метель; подмётка
Мех: мех, меховой
Меч: меч, мечевой, мечевик
Меш: мешок, мешковина
Миг/мг: миг, мигать; мгновение, мгновенный
Мил: милый, миловать
Мим: мимо
Мир: мир, мирный, мирить
Мк/мык/мыч: разомкнуть, размыкать, отмычка
Млеч: млечный
Мн/мя/мин: мни, мять, разминать
Мн/мя/мин: помни, память, вспоминать
Мог/мож/моч: могу, может, мочь, могучий
Мозг/мозж/мызг: мозг, размозжить
Мой/мы: мой, мыть, отмывать
Мок/моч: мокрый, мокнуть, мочить
Мол: мол
Мол: молить, мольба
Молв: молва
Молн: молния
Молок: молоко, молочный
Мор: море, морской, моряк
Мор/мер/мёр/мир: мор, морить; умер, смерть; мёртвый; умирать
Морг: моргать, моргание
Морд: морда
Мороз/мерз/мёрз: мороз, морозить, мороженный; замерзать, мёрзнуть, мерзкий
Морок/мороч/мерк: морока, морочить; меркнуть, сумерки, мерцание
Морщ: морщить, морщина
Мост/мощ: мост, мостить; мощенный
Мот/мат: мот, мотать; наматывать
Мох: мох
Мош: мошна
Мрак/мрач: мрак, мрачный
Муд: муди
Муд(р): мудрый
Мук/муч: мука, мучной
Мук/муч/мык: мука, мучить; мыкаться
Мул: мул
Мур(ав): мурава; муравей
Мут: муть, мутный, мутить
Мух/муш/мош: муха, мушка; мошка
Мыс: мыс
Мыс(л): мысль, мыслить, смысл, мышление
Мыт: мыт
Мыч: мычать, мычание
Мыш: мышь; мышца
Мяс: мясо, мясной, мясистый
Мяч: мяч
Раб: раб, работать
Рад: радеть; радовать, радость
Раз/роз: раз, рас, роз, рос
Рак/рач: рак, рачий
Рал: рало
Ран: рана, ранить
Ран: рано
Рат: рать, ратный
Рач: рачительный
Рв/рыв: рвать, разрывать
Реб: ребёнок, ребята
Реб(р): ребро
Рев/рёв: реветь, рёв
Рев(ен): ревень
Ред/реж: редкий, реже
Рез: резать, резкий, резь
Рей/рой: реять; рой
Рек/рёк/реч/рц/рок/роч: предрёк, предрекать; речь; урок
Рек/реч: река, речка
Ремен: ремень, ременной
Реп: репа
Рес(н): ресница
Реш: решать, решение
Рин: ринуться
Рис: рисовать, рисунок
Ров/рав: ровный, равный
Рог: рог, роговой
Род/рож: род, народ, родной, родить, рожать, рождаться
Розг: розги
Рой/ры/ров/рв: рой, рыть, рыло, рыхлый; ров, рва
Рон: ронять, урон
Рос/рош: роса, орошать
Рост/рощ/раст/ращ: росток, роща, растить, выращивать
Рот: рот, ротовой
Руб/ряб: рубить; рябой; рябчик; рябина
Руг: ругать
Руд/рд/рыж/рж: руда; рдяной; рыжий; ржавый
Рук/руч: рука, ручной
Рух/руш: рухнуть, рушить
Рыб: рыба
Рыг: рыгать
Рыд: рыдать
Рык/рыч: рык, рыкать, рычать
Рыс: рысь; рыскать, рыщет
Ряд/руж: ряд, рядить, наряд, заряд; ружьё
Пад/паж/пащ: падать
Пал: палить
Пал: палить
Пал: палка, палец
Пар: пар, паровой, пАрить
Паст: пасть
Паст: пасти, пастух, пастбище
Пах: пахнуть, запах
Пах: пах; запахивать
Пах/паш: пахать, пашня
Паук: паук
Пей/пи/пь: пей, пить, пир, питьё, пьяный
Пек/печ: пеку, печь, пекарь; печка, печник, печенье
Пен: пена, пениться
Перд: пердеть
Перст/пёрст: перст, напёрсток, наперстник
Пест: пестовать
Пех/пеш: пехота, пешком, пешка, спешить, спешиться, опешить
Печ(ат): печать, печатать
Пи@д: пихать
Пик: пика
Пик: пикнуть
Пил: пилить, пила
Пин/пн: пинать, пинок, пнуть
Пис: пИсать, пописить, писька
Пис/пиш: писАть, пишет, письмо, писарь
Писк/пищ: писк, пищать, пискливый
Пит: питать, питание, пища
Пих: пихать
Плет/плес/плё: плеть; плести, плёл
Плак/плач: плакать, плач
Плат/плач: платить; уплачено
Плах/плош: плаха, плошмя
Плев/плёв/плю: плевать, плюнуть, плевок
Плеск/плес/плещ: плеск, плеснуть, плещет
Плод: плодить, плод, плодовый, плодовитый
Плоск/площ: плоский, уплощенный, площадь
Плот: плоть, плотный
Плох/плош: плохой, оплошать
Плут: плут, плутовской
Плы/плав/плов: плыть, плыви; плавать, плавание; пловец
Плющ: плющ, плющить
По, под: по, под
Позд/позж: поздно, позже
Пой/пе: пой, песня
Покой/покай: покой, спокойный; успокаивать
Пол: пол, полы, половица
Пол: пол; половина
Пол: полный, наполнять
Пол/пал: полый
Пол/плам: полыхать, всполох; полымя, пламя, пламенный
Полз/полоз: ползать, полоз
Полог: полог, пологий
Полон: полон, полонить, полонянка; плен, пленить, пленник
Полос: полоса, полосовать
Полот/плат: полотно, полотенце
Пор/пар: поры
Порос: поросёнок, поросячий
Пост: пост, постный, поститься
Пот: пот, потный, потеть
Поч(к): почка
Пра: прародина
Прав: правый, правильный; править
Празд: праздный, праздник
Прач: прачечная
Пращ: праща
Проб: проба, пробовать
Проб: пробка
Прос: просить
Прос: просо, просяной
Прост/прощ: простить, прощать, прощение
Прост/прощ: просто, простой, проще, упростить, упрощать
Пруг/пруж/пряг/пряж/пряч: упругий, подпруга, пружина; запрягать, запряженный, напрячь
Пруд/пруж: пруд, прудить, запруженный
Прут: прут
Прыг/прыж/пры: прыгать, прыжок
Пряд/пряж: прядь, пряжа, прясть; пряха
Прям: прямой
Прян: пряность, пряный
Прят/пряч: прятать, прятки, упрячь
Пт: птица, птаха, птенец
Пуз: пузо, пузырь
Пуг/пуж: пугать
Пук/пуч/пяч: пукать; пучить; выпячивать
Пуп: пуп
Пуск/пущ: пуск, пускать, пущенный
Пуст/пущ: пустой, пуща
Пут: путы, путать
Пут: путь, путник, путевой
Пух/пуш/пыш: пух, пушистый; пышный
Пыж: пыж, пыжиться
Пыр: пырять, пырнуть
Пыт: пытать, пытка, пытливый
Пых: пыхтеть, запыхаться; пЫхать
Пяд: пядь
Пял: пялить
Пят: пять, пятый
Пят: пята
Пят: пятно, пятнистый, пятнашки
Цап: цапать
Цап(л): цапля
Царап: царапать
Цев: цевьё
Цел: целый
Цен: цена, ценить, ценный
Цеп: цепь, цепной
Цок: цокать
Цокол: цоколь
Цык: цыкать
Цыпл: цыплёнок
