рисовальщица: рис
фаготный: фагот
перинный: пер
тянтый: тя
испытательный: испыт
глаголица: глагол
удоб|+о|(зр
всучивать: всуч
чтобы: чтобы
лужение: луж
таблетка: таблетк
горшечник: горшеч
трудящиеся: труд
конфирмованный: конфирм
тампонировать: тампон
ломота: лом
жирность: жир
модерный: модерн
злосчастный: зл
снеготаялка: снег
актин: актин
пред(мет
штилевой: штил
щёлочность: щёлоч
гомоцентрический: гом
вопросительный: вопрос
гетманский: гетман
шатенка: шатен
ази}{
ази}{
вельвет: вельвет
гипотетический: гипотет
дофоб:юд
действенный: дей
гамма-глобулин: гамм
программно-целевой: программ
огорчённый: огорч
звездануть: звезд
межполосье: меж
брелок: брелок
ифик}{
ифик}{
работаться: работ
откровенность: откровенн
ионизироваться: ион
стереосъёмка: стере
молоточек: молот
ир}{о
ир}{о
полог: полог
кусать: кус
бирюлечный: бирюлеч
станок-автомат: стан
трясучий: тряс
одностопный: одн
спецкурс: спец
ляузничать:кляуз
магнитоэлектрический: магнит
вперять: впер
тракторостроитель: трактор
жалко: жал
трощение: трощ
самоутвердиться: сам
лисонька: лис
колоритный: колорит
година: год
и}
и}
эфа: эф
таивать:став
пастила: пастил
синод: синод
геология: гео
сусек: сусек
(клон
ир}{ов
ир}{ов
падина: пад
кречётка: кречёт
программно-методический: программ
космография: косм
жиный:уж
рабеск:арабеск
спортсмен-разрядник: спорт
пресс-брифинг: пресс
азанарий:фазан
синусный: синус
шорка: шор
препаровочный: препар
верт}{
верт}{
пластинник: пластин
флотоводец: флот
чуланчик: чулан
гемоглобинный: гем
иотит:био
одогрейка:вод
купиться:скуп
фенхель: фенхель
полярник: пол
сноха: снох
рицинный: рицин
хлыщущий: хлыщ
психолингвистика: псих
минераловоз: минерал
аннексия: аннекси
ифик}{
ифик}{
инерционный: инерци
каллиграф: каллиграф
ляшский: ляш
красота: крас
мозаика: моза
телеграфия: теле
прожектёрство: прожект
мешочек: мешоч
наказ: наказ
жасмин: жасмин
концептуализм: концепт
(крепост
аной:щ
двуперстый: дв
сукновал: сукн
икряник: икр
техн}{и
техн}{и
коррадировать: коррад
кормило: корм
малоценный: мал
однокорневой: одн
(терап
кислородсодержащий: кислород
горничная: горнич
сумасброд: сумасброд
анафематствовать: анафем
лотошный: лото
хлебопашец: хлеб
(ум
ль}{
ль}{
жидкостно-ракетный: жидк
мукомол: мук
жёлоб: жёлоб
магия: маги
жилфонд: жи
синь: синь
шанс: шанс
овал: овал
пред(мет
ов}{ист}{с
ов}{ист}{с
арендование: аренд
кильватерный: киль
(крепост
ёв}
ёв}
ум: ум
(шарнир
ёва}{н
ёва}{н
монументалист: монумент
инвентарь: инвентарь
поздно: поздн
скоп: скоп
будущий: буд
шахсей-вахсей: шахсей
фашизировать: фаш
